vysoce -> highly
hřebík -> nail
slunce -> sun
míchat -> to stir
emoce -> emotion
tati -> dad
měsíc -> month
měsíc -> moon
výlet -> trip
uklidnit -> calm
originál -> original
strach -> fear
strach -> afraid
na pohled -> to glare
oběť -> victim
kultury -> culture
účel -> purpose
přísahat -> to swear
povinnost -> duty
projektu -> project
do trávy -> to grasp
spící -> asleep
krásná -> beautiful
třicet -> thirty
najít -> to find
rána -> wound
driftovat -> to drift
špinavý -> dirty
sdružovat -> to associate
podobný -> similar
hořký -> bitter
rovnováhu -> balance
zaklepat -> to knock
ne -> not
ne -> no
rádia -> radio
radost -> joy
román -> novel
výhoda -> advantage
kopec -> hill
k pronájmu -> to rent
na okamžik -> to snap
Škoda -> pity
přesvědčit -> to convince
přesvědčit -> to persuade
dvanáct -> twelve
důvod -> reason
povodně -> flood
druhý -> second
mysl -> mind
lůžko -> bed
druhé -> latter
stát -> to stand
stát -> state
točit -> to twist
točit -> to spin
svítilna -> lamp
poslouchat -> to listen
kapela -> band
zvláště -> especially
sestra -> sister
studovat -> to study
šest -> six
ztráta -> loss
sukně -> skirt
návrh -> suggestion
náš -> our
inteligence -> intelligence
východ -> east
oženit se -> to marry
okraj -> edge
nemovitý -> real
sobota -> Saturday
známkovat -> to mark
do výfuku -> to exhaust
když -> when
dlužit -> to owe
zmrazit -> to freeze
oblečení -> clothes
okolnost -> circumstance
ostatní -> others
špatně -> wrong
špatně -> badly
k závěru -> to conclude
čas -> time
předpokládat -> to assume
oceán -> ocean
odpoledne -> afternoon
sám -> himself
sám -> itself
zkontrolovat -> to check
svíčka -> candle
brána -> gate
loket -> elbow
kriminální -> criminal
zobrazit -> to display
plavidla -> vessel
kabát -> coat
brada -> chin
vážné -> serious
hadr -> lap
srdce -> heart
opřít -> to lean
poušť -> desert
dřevěný -> wooden
sekce -> section
mocný -> mighty
sociální -> social
na pneumatiku -> to tire
otřete -> to wipe
klienta -> client
hledat -> to seek
polský -> poet
dva -> two
zločin -> crime
stehna -> thigh
odkazovat -> to refer
duše -> soul
divné -> rare
půvabný -> lovely
rušit -> to disturb
objekt -> object
v -> in
v -> at
varovat -> to warn
paříž -> Paris
do května -> to may
zásobování -> supply
mládí -> youth
pop -> to pop
kůň -> horse
zůstat -> to stay
zůstat -> to remain
napájení -> power
hloupý -> stupid
nedávno -> recently
nedávno -> recent
zoufalý -> desperate
vyskytnout -> to occur
stěžovat -> to complain
potěšit -> to please
přední -> front
vy -> you
určit -> to determine
počasí -> weather
zpomalit -> slow
tucet -> dozen
materiál -> material
čtyři -> four
jaro -> spring
společník -> companion
číst -> to read
přízemní -> ground
úkol -> task
deset -> ten
zármutek -> sorrow
auto -> car
měkce -> softly
nicméně -> however
vystupovat -> to perform
čerstvý -> fresh
pohovka -> sofa
pokoj, místnost -> room
zaměstnávat -> to employ
vláčet -> to drag
snadný -> easy
šaty -> gown
najmout -> to hire
udržovat -> to maintain
hlavní -> main
hlavní -> chief
sprcha -> shower
loď -> ship
loď -> boat
telefon -> phone
telefon -> telephone
cestujícího -> passenger
popíjet -> to sip
škola -> school
reakce -> reaction
metody -> method
oddělit -> to separate
pomalu -> slowly
obrázek -> picture
stvoření -> creature
příkaz -> command
spousta -> plenty
vozu -> wagon
rozzlobený -> angry
magie -> magic
nikdy -> never
svítání -> dawn
identifikovat -> to identify
přijít -> to come
přírodní -> natural
poté -> afterwards
politický -> political
hrdlo -> throat
vyjádřit -> to express
žehlička -> iron
stabilní -> steady
o -> about
utratit -> to spend
suchý -> dry
pohyb -> motion
zápěstí -> wrist
kámen -> stone
hořet -> to burn
otrok -> slave
odpočinek -> rest
foukat -> to blow
mračit se -> to frown
záměr -> intention
kyčle -> hip
vláda -> government
přistupovat -> to approach
vězení -> prison
řvát -> to roar
zavolat -> to call
popis -> description
rozvoje -> development
vánoce -> Christmas
jeskyně -> cave
společný -> common
všude -> everywhere
březen -> March
bezpečnosti -> safety
pan -> Mr
stonek -> steel
prostor -> space
manželství -> marriage
uvízl -> vast
systém -> system
záře -> glow
tlačítko -> button
ukázat -> to show
slečna, minout -> Miss
vytáhnout -> to pull
stránka -> page
dvacet -> twenty
připojit se -> to join
někdo -> someone
někdo -> somebody
někdo -> anybody
roztrhnout -> tear
odměnu -> reward
hranice -> border
doktor -> doctor
úzký -> narrow
zasténat -> to groan
služka -> maid
tlustý -> thick
tlustý -> fat
vlak -> train
předchozí -> previous
následkem -> consequence
báseň -> poem
orgánu -> authority
zvědavý -> curious
a -> and
a -> a
a -> an
zub -> tooth
hřích -> sin
jazyk -> language
jazyk -> tongue
obnovit -> to recover
plynout -> to flow
vlastně -> actually
legrační -> funny
teplý -> warm
klouzat -> to slide
spíše -> rather
vsadit -> to bet
dřevo -> wood
příběh -> story
příběh -> tale
názor -> opinion
klid -> quiet
navzdory -> despite
móda -> fashion
tiše -> quietly
tiše -> silently
spolu -> together
brýle -> glasses
užívat si -> to enjoy
učitel -> teacher
objevit se -> to appear
protestovat -> to protest
hvězda -> star
tempo -> pace
porovnat -> to compare
královna -> queen
vynikající -> excellent
třást se -> to tremble
platit -> to pay
cítit -> to feel
cítit -> to smell
představit si -> to imagine
beletrie -> fiction
realita -> reality
možný -> possible
v opačném případě -> otherwise
chabý -> faint
polovina -> half
pochodovat -> to march
služba -> service
dokud -> until
celkem -> total
věřit -> to believe
věřit -> to trust
současnost, dárek -> present
šťastný -> happy
připojení -> to connect
tady -> here
hloupost -> foolish
jistě -> surely
okno -> window
ostrý -> sharp
taky -> also
následovat -> to follow
sympatie -> sympathy
pohřbít -> to bury
kořen -> root
pozice -> position
ošklivý -> ugly
úspěšné -> successful
bush -> bush
závod -> race
dveře -> door
dostat -> to get
drát -> wire
právník -> lawyer
překvapit -> to surprise
oko -> eye
směrem k -> toward
schopnost -> ability
zničit -> to destroy
zničit -> to ruin
kdekoli -> anywhere
není schopen -> unable
přes -> over
přes -> through
přes -> across
sát -> to suck
rozdělit -> to divide
ohrožovat -> to threaten
nativní -> native
sakra -> damn
dítě -> child
dítě -> baby
dítě -> kid
odvážit se -> to dare
zápas -> match
francouzština -> French
hora -> mountain
drahocenný -> precious
příklad -> example
styl -> style
položit -> to lay
spojení -> connection
díky -> thanks
pistole -> gun
pistole -> pistol
stejně -> equally
přidat -> to add
kreslit -> to draw
u -> near
kráva -> cow
skutečný -> TRUE
Černá -> black
spravovat -> to manage
vyplnit -> to fill
paže -> arm
pokleknout -> to kneel
zranit -> to hurt
vstoupit -> to enter
údolí -> valley
část -> part
už ne -> anymore
vlastníkem -> owner
rozbít -> to break
růžový -> pink
vůbec -> ever
šílený -> mad
šílený -> crazy
město -> town
město -> city
zapůsobit -> to impress
obra -> giant
nápověda -> hint
hnutí -> movement
aby se zabránilo -> to prevent
oni -> they
odpustit -> to forgive
smyslu -> sense
hrůza -> horror
hrůza -> terror
hrůza -> dread
teta -> aunt
vlevo, odjet -> left
hnědý -> brown
hodiny -> clock
podezírat -> to suspect
narození -> birth
možnost -> possibility
přát si -> to wish
vinen -> guilty
pokrýt -> to cover
konec -> end
neděle -> Sunday
komory -> chamber
tvůj -> thy
číslo -> number
společenství -> community
hrozné -> awful
mentální -> mental
řetěz -> chain
zemřít -> to die
si zaslouží -> to deserve
nepořádek -> mess
učit -> to teach
již -> already
ucho -> ear
hmotnost -> weight
hmotnost -> mass
prodejna -> shop
ohýbat -> to bend
byt -> apartment
titul -> title
ke zvýšení -> to raise
obrovský -> huge
chytrý -> smart
skvělý -> great
ovoce -> fruit
kov -> metal
delikátní -> delicate
lhát -> to lie
zmást -> to confuse
dvojnásobek -> double
průhledná -> clear
věc -> thing
na škrábnutí -> to scratch
noc -> night
povzdechnout -> to sigh
dvakrát -> twice
chrámu -> temple
učit se -> to learn
s -> with
mírný -> slight
most -> bridge
blázen -> fool
konverzace -> conversation
zajistit -> to assure
hodnosti -> rank
muset -> to must
několik -> several
na dotek -> to touch
stav -> condition
polštář -> pillow
minuta -> minute
žádost -> request
hudba -> music
považovat -> to regard
dlaň -> palm
místo toho -> instead
procesu -> trial
také -> too
praxe -> practice
pochybovat -> doubt
krk -> neck
plocha -> area
níže -> below
nebo -> or
firmy -> firmly
koleno -> knee
reprezentovat -> to represent
pověsit -> to hang
hněv -> anger
noviny -> newspaper
to -> it
vybrat -> to pick
vybrat -> to choose
směr -> direction
pozastavit -> to pause
sexuální -> sexual
změnit -> to change
štěstí -> fortune
štěstí -> luck
štěstí -> happiness
štěstí -> lucky
varování -> warning
lehce -> lightly
stížnost -> grief
dnes večer -> tonight
stejný -> same
posunout -> to shift
ani -> nor
ani -> neither
pozadí -> background
dodat -> to deliver
stráž -> guard
zapojit -> to involve
zapojit -> to engage
kus -> piece
manžel -> husband
cesta -> path
cesta -> journey
pohřeb -> funeral
zamést -> to sweep
ráno -> morning
kapitán -> captain
mohl -> could
holý -> bare
široký -> wide
široký -> broad
zdraví -> health
záznam -> record
jiný -> other
jiný -> else
zvláštní -> strange
zvláštní -> odd
dlouho -> long
vidění -> vision
týden -> week
získat -> to gain
získat -> to obtain
hádat se -> to argue
domov -> home
vědy -> science
zmizet -> to disappear
zmizet -> to vanish
akce -> action
obsahovat -> to contain
chlapče -> lad
paměť -> memory
schovat -> to hide
nůž -> knife
že -> that
střední -> middle
vázaný -> bound
signál -> signal
soukromé -> private
období -> term
nálada -> mood
Června -> June
šklebit se -> to grin
osud -> fate
řídit -> to drive
řídit -> to direct
knihovna -> library
vlastnictví -> property
maso -> meat
uvolnit -> to release
uvolnit -> to relieve
nepřítel -> enemy
bod -> point
bod -> spot
centrum -> center
hlava -> head
zlato -> gold
obecně -> generally
déšť -> rain
šelma -> beast
plně -> fully
vzhled -> appearance
dobrodružství -> adventure
zákon -> law
taška -> bag
vařit -> to cook
ctnost -> virtue
voják -> soldier
muž -> man
poznámka -> note
opatrný -> careful
stan -> tent
daleko -> far
vlastní -> own
vlastní -> proper
úzce -> closely
vykreslit -> to render
spravedlivě -> fairly
úleva -> relief
komentář -> comment
vystavit -> to expose
přirozeně -> naturally
přátelství -> friendship
k postupu -> to advance
obdivovat -> to admire
k havárii -> to crash
svobodu -> freedom
rytíř -> knight
obraz -> image
dovolit -> to allow
dovolit -> to afford
silnice -> road
plavat -> to float
plavat -> to swim
aspekt -> aspect
nerv -> nerve
vůdce -> leader
zlomený -> broken
držení -> possession
nervový -> nervous
fyzický -> physical
nízký -> low
každý -> every
každý -> each
každý -> everyone
dům -> house
přejít -> to cross
rozdíl -> difference
neobvyklé -> unusual
hodnotit -> rate
příroda -> nature
chudý -> poor
zajímavý -> interesting
podporovat -> to support
svědectví -> witness
kufr -> trunk
tradici -> tradition
snaha -> effort
vlastnosti -> feature
milión -> million
anglie -> England
malovat -> to paint
odrážet -> to reflect
vůně -> scent
písek -> sand
zastavit -> to stop
zastavit -> to halt
pryč -> away
prdel -> ass
očividně -> obviously
pušky -> rifle
mě -> me
žlutá -> yellow
konečně -> finally
promiňte -> sorry
k creepu -> to creep
vzdělávání -> education
prkno -> board
vztahovat -> to relate
etapa -> stage
živobytí -> living
zejména -> particularly
informovat -> to inform
tón -> tone
usmát se -> to smile
Řečtina -> Greek
vyžadovat -> to require
náboženství -> religion
projít -> to pass
myslel -> thought
voda -> water
kývnout -> to nod
pohled -> to glance
pohled -> sight
pohled -> view
pohled -> gaze
pohled -> glimpse
občana -> citizen
moudrý -> wise
nyní -> now
hádat -> to guess
chladný -> cool
nepřítomnost -> absence
někdy -> sometimes
dějiny -> history
vysoká škola -> college
hodně -> much
hodně -> lot
koupelna -> bathroom
starověké -> ancient
obtížnost -> difficulty
co -> what
indikovat -> to indicate
seznam -> list
dnes -> today
z -> of
z -> from
tento -> this
kabelku -> purse
opona -> curtain
vysvětlit -> to explain
sedící -> seated
chlapík -> fellow
zadní -> back
zadní -> rear
restaurace -> restaurant
otevření -> opening
dokázat -> to prove
zamknout -> to lock
špatný -> bad
povrch -> surface
proces -> process
hanba -> shame
úspěch -> success
kamionu -> truck
neznámé -> unknown
modlit se -> to bid
sledovat -> to watch
sledovat -> to pursue
jezdit -> to ride
modelu -> model
měkký -> soft
rozumět -> to understand
pasu -> waist
tím pádem -> thus
odolávat -> to resist
řeka -> river
použít -> to use
použít -> to apply
padesáti -> fifty
připnout -> to pin
nakrmit -> to feed
vojenský -> military
pobřeží -> shore
pobřeží -> coast
růst -> to grow
růst -> to rise
chvála -> praise
jasný -> bright
určitý -> certain
volání -> belt
přistát -> land
účastnit se -> to attend
snídaně -> breakfast
předmět -> subject
pusa -> mouth
přítomnost -> presence
tvář -> face
tvář -> cheek
držet -> to hold
držet -> to stick
publikum -> audience
osamělý -> lonely
hladký -> smooth
vy sám -> yourself
rozsah -> range
bledý -> pale
dělat -> to do
dělat -> to make
zvědavost -> curiosity
odpovědnosti -> responsibility
k pat -> to pat
okamžitý -> instant
násilí -> violence
chod -> course
vést -> to lead
naproti -> opposite
podezření -> suspicion
tančit -> to dance
bývalý -> former
schopný -> able
schopný -> capable
umýt -> to wash
krátký -> short
přerušit -> to interrupt
udělit -> to grant
pravidelné -> regular
rameno -> shoulder
událost -> event
zvonek -> bell
šokovat -> shock
v pořádku -> fine
se chvějí -> to shiver
trik -> trick
probudit -> to wake
zavést -> to introduce
hezký -> handsome
k vyhledávání -> to search
zášť -> spite
třída -> class
zásob -> stock
stát se -> to become
stát se -> to happen
zapomenout -> to forget
zatknout -> to arrest
navrhnout -> to suggest
navrhnout -> to propose
dosud -> yet
pokus -> attempt
tvar -> shape
osm -> eight
hlavní, důležitý -> major
nic -> nothing
kancelář -> office
speciální -> special
rychlý -> quick
divit -> to wonder
doprovázet -> to accompany
oběd -> lunch
přepnout -> to switch
kariéru -> career
obchod -> deal
obchod -> store
obchod -> trade
dolar -> dollar
mužský -> male
trvat na tom -> to insist
čepel -> blade
tam -> there
poskytnout -> to provide
prohlášení -> statement
většina -> most
výmluva -> excuse
milost -> grace
stezka -> trail
brzy -> early
tak jako tak -> anyway
nemocný -> ill
nemocný -> sick
odlišný -> different
úvěru -> credit
konkrétní -> particular
uklouznout -> to slip
rozhodně -> certainly
zbraň -> weapon
olej -> oil
složku -> map
obávat se -> to concern
naložit -> to load
účinek -> effect
večer -> evening
let -> flight
přímo -> directly
evropy -> Europe
tělo -> body
tělo -> flesh
sedět -> to sit
vzdálenost -> distance
náklady -> cost
proti -> against
strom -> tree
dobrý -> good
dobrý -> brave
začít -> to begin
začít -> to start
autor -> author
kvalitní -> quality
oddělení -> department
slíbit -> to promise
podél -> along
cokoliv -> anything
řízení -> control
příležitost -> occasion
příležitost -> opportunity
americký -> American
příjezdu -> arrival
připojit -> to attach
často -> often
uspořádání -> arrangement
pít -> to drink
list -> sheet
bič -> to whip
vnímat -> to perceive
sama -> alone
velikost -> size
populární -> popular
proklínat -> to curse
vysvětlení -> explanation
zrcadlo -> mirror
zahrnout -> to include
na vině -> to blame
rychlost -> speed
komfortní -> comfortable
mimo -> outside
mimo -> beyond
ale -> but
stáří -> age
smát se -> to laugh
smát se -> to chuckle
laskavost -> favor
cigareta -> cigarette
pouze -> only
pouze -> merely
pól -> pool
energie -> energy
nahoru -> up
nahoru -> upstairs
žádný -> any
žádný -> none
tahu -> to thrust
střecha -> roof
zájem -> interest
zájem -> interested
Řidič -> driver
svět -> world
poštou -> mail
světlo -> light
zřejmé -> obvious
odmítnout -> to refuse
stroj -> machine
rovný -> straight
blikat -> to flash
blikat -> to blink
v celém rozsahu -> throughout
pomoci -> to help
datum -> date
obdržet -> to receive
kristus -> Christ
nalít -> to pour
usadit -> to settle
osoba -> person
kouř -> smoke
strop -> ceiling
přátelský -> friendly
způsob -> way
způsob -> manner
jídlo -> food
jídlo -> meal
letní -> summer
vliv -> influence
deska -> plate
mrtvý -> dead
minulost -> past
odebrat -> to remove
Červenec -> July
nabobtnat -> to swell
západ -> west
slavný -> famous
kartáčovat -> to brush
tlaku -> pressure
čekat -> to wait
korunu -> crown
mír -> peace
nás -> us
to je jedno -> whatever
moderní -> modern
podnik -> to venture
válečník -> warrior
sedm -> seven
vážně -> seriously
nést -> to carry
nést -> to bear
potkat -> to meet
hladový -> hungry
stranou -> aside
vchod -> entrance
vchod -> doorway
k obsazení -> to cast
výraz -> expression
pravda -> truth
ukrást -> to steal
následující -> following
znovu -> again
okamžitě -> instantly
bezpečnostní -> security
uniknout -> to escape
odhalit -> to reveal
bez -> without
zvuk -> sound
ušetřit -> to spare
všechno -> all
všechno -> everything
měl -> to ought
blok -> block
teorie -> theory
svalu -> muscle
zvyk -> habit
zvyk -> custom
člověk -> human
slovo -> word
dětství -> childhood
já -> I
buňka -> cell
drobný -> tiny
hedvábí -> silk
výzvou -> challenge
modrý -> blue
milovat -> to love
zpráva -> report
zpráva -> message
zvlnit -> to curl
skočit -> to jump
skočit -> to leap
preferovat -> to prefer
dno -> bottom
strukturu -> structure
k montáži -> to mount
dech -> breath
veřejnost -> public
tě -> thee
úroveň -> level
věci -> stuff
oba -> both
chytit -> to catch
chytit -> to seize
běžet -> to run
indický -> Indian
bolest -> pain
večírek -> party
vyměnit -> to exchange
připravit -> to prepare
hrát -> to play
hrát -> to act
práce -> job
letět -> to fly
důvěra -> confidence
protože -> because
slabý -> weak
mrtvice -> stroke
očekávat -> to expect
zabalit -> to wrap
vzít -> to take
čtvrťák -> quarter
všeobecné -> general
zahrada -> garden
hlas -> voice
dojem -> impression
košile -> shirt
hrdý -> proud
vzor -> pattern
prasknout -> to burst
prasknout -> to crack
čelo -> forehead
na procházku -> to walk
sotva -> barely
sotva -> scarcely
naštvaný -> to upset
pracovat -> to work
služebník -> servant
zamýšlet -> to intend
smrt -> death
schody -> trap
my -> we
století -> century
jezero -> lake
libra -> pound
přestat -> to cease
nahlédnout -> to peer
vzlykat -> to sob
láhev -> bottle
britský -> British
syn -> son
mluvený projev -> speech
hloubky -> depth
kulka -> bullet
jejich -> their
život -> life
krok -> step
krok -> to stride
vítr -> wind
zaměstnanců -> staff
bitva -> battle
Žid -> Jew
přinést -> to bring
nabít -> charge
cíl -> to aim
odezva -> response
ryba -> fish
odděleně -> apart
pošta -> post
odvahu -> courage
strýc -> uncle
chránit -> to protect
víno -> wine
neuspět -> to fail
možná -> perhaps
možná -> maybe
možná -> possibly
šance -> chance
znalost -> knowledge
mistr -> master
jednoduchý -> simple
zvíře -> animal
boční -> side
zprávy -> news
těsný -> tight
třetí -> third
krvavý -> bloody
miláčku -> darling
kde -> where
vážený pane -> sir
generace -> generation
vztek -> rage
brilantní -> brilliant
koupit -> to buy
přesně tak -> exactly
vzrušení -> excitement
milý -> dear
rozhodnout -> to decide
bouřka -> storm
vzdálený -> distant
prostý -> plain
mise -> mission
plout -> to sail
tendenci -> to tend
problém -> problem
problém -> issue
kostel -> church
píseň -> song
důkaz -> evidence
důkaz -> proof
pamatovat si -> to remember
potěšení -> pleasure
sebrat -> to grab
tlačit -> to push
tlačit -> to press
litovat -> to regret
ruština -> Russian
udeřit -> to hit
kulhat -> to slap
po -> after
odpovědný -> responsible
zírat -> to stare
jednoduše -> simply
bojovat -> to fight
bojovat -> to struggle
sestupovat -> to descend
čtyřicet -> forty
cestovat -> to travel
úplně -> altogether
babička -> grandmother
obrazovka -> screen
nedostatek -> lack
stupeň -> degree
zvolat -> to exclaim
poděkovat -> to thank
pes -> dog
Číňané -> Chinese
bratr -> brother
ty -> those
obvyklý -> usual
duben -> April
pronásledovat -> to chase
příteli -> friend
jehož -> whose
setkání -> meeting
setkání -> to encounter
spiknutí -> plot
pozdě -> late
čistý -> clean
čistý -> pure
méně -> less
oznámit -> to announce
hmota -> matter
oblek -> suit
prázdný -> empty
fráze -> phrase
kouzlo -> charm
kouzlo -> spell
vědět -> to know
upustit -> to drop
oblíbené -> favorite
ignorovat -> to ignore
tak jako -> as
mezi -> between
mezi -> among
jemně -> gently
studený -> cold
londýn -> London
kdykoliv -> whenever
pokračovat -> to continue
pokračovat -> to proceed
můj -> my
ochotný -> willing
krása -> beauty
rozdrtit -> to crush
lézt -> to climb
cizinec -> stranger
spěchat -> to rush
spěchat -> to hurry
všichni -> everybody
něco -> something
vyslovit -> to utter
malý -> small
účet -> account
účet -> bill
obléknout se -> to dress
hodit -> to throw
hodit -> to toss
rukojeť -> grip
diskuse -> discussion
zatajit -> to conceal
plot -> fence
podpory -> aid
vděčný -> grateful
k útěku -> to fling
boty -> shoe
vytvořit -> to create
spisovatel -> writer
obyčejné -> ordinary
židle -> chair
až do -> till
důstojník -> officer
otvor -> hole
probrat -> to discuss
pár -> couple
pár -> pair
palec -> inch
uspokojit -> to satisfy
smutný -> sad
pěst -> fist
zřejmě -> apparently
ďábel -> devil
vedle -> beside
rozhodnutí -> decision
rozhodnutí -> judgment
křesťan -> Christian
vozidla -> vehicle
skupina -> group
obtěžovat -> to bother
lekce -> lesson
přijet -> to arrive
slepý -> blind
tyto -> these
zajíknout se -> to gasp
chyba -> mistake
chyba -> fault
stávku -> to strike
návštěvník -> visitor
pocit -> feeling
nebezpečí -> danger
ona -> she
káva -> coffee
perfektní -> perfect
aktivita -> activity
kompletní -> complete
záviset -> to depend
výběrového řízení -> tender
starat se -> to care
dychtivý -> eager
pokroku -> progress
doba -> period
zachránit -> to save
mozek -> brain
cizí -> foreign
příjemný -> pleasant
pouhý -> mere
žert -> joke
úředník -> official
úředník -> clerk
k odvolání -> to recall
k odvolání -> to appeal
třít -> to rub
hluk -> noise
otevřít -> to open
absolutně -> absolutely
vzhůru -> awake
břicho -> belly
tma -> darkness
kněz -> priest
porozumění -> understanding
jíst -> to eat
zeptat se -> to ask
zeptat se -> to inquire
zlo -> evil
odstín -> shade
říct -> to say
říct -> to tell
nový -> new
peníze -> money
kapitolu -> chapter
vyřešit -> to resolve
dort -> cake
vyvinout -> to develop
právní -> legal
sezóny -> season
trhu -> market
bytost -> being
kmene -> to strain
doufat -> to hope
gesto -> gesture
psát -> to write
rodina -> family
nabídnout -> to offer
křivky -> curve
sklenka -> glass
hodnota -> worth
hodnota -> value
velmi -> very
problémy -> trouble
objem -> volume
válet -> to roll
chléb -> bread
společnost -> company
společnost -> society
najednou -> suddenly
políbit -> to kiss
zvýšit -> to increase
zvážit -> to consider
budova -> building
pracovníka -> worker
spadnout -> to fall
pole -> field
kontakt -> contact
proudu -> current
přiznat si -> to admit
člen -> member
banka -> bank
název -> name
umělec -> artist
kolem -> around
povolení -> to permit
povolení -> permission
nemožné -> impossible
obejmout -> to hug
nejméně -> least
křídlo -> wing
nakonec -> eventually
nevinný -> innocent
tak -> so
ušlechtilý -> noble
pro potvrzení -> to confirm
zradit -> to betray
gauč -> couch
srpen -> August
obvykle -> usually
poslat -> to send
od té doby -> since
tři -> three
strčit -> to shove
stlačit -> to squeeze
rodič -> parent
vítejte -> welcome
obvinit -> to accuse
výzkumu -> research
počítače -> computer
proud -> stream
vskutku -> indeed
dcera -> daughter
činidlo -> agent
aféra -> affair
výběr -> choice
sen -> dream
vůči -> towards
jeden -> one
denně -> daily
poradenství -> advice
provádět -> to conduct
souseda -> neighbor
vánek -> breeze
většinou -> mostly
čepice -> hat
čepice -> cap
lékařské -> medical
uspokojení -> satisfaction
nebe -> sky
nebe -> heaven
rozkoš -> delight
uspořádat -> to arrange
že jo -> right
houpat se -> to swing
šedá -> gray
šedá -> grey
ještě pořád -> still
opakovat -> to repeat
vědomé -> aware
vědomé -> conscious
lovit -> to hunt
nahradit -> to replace
připraven -> ready
druh -> kind
druh -> sort
divoký -> wild
kost -> bone
pravděpodobně -> probably
pravděpodobně -> likely
tráva -> grass
psaní -> writing
situace -> situation
zpívat -> to sing
modlitba -> prayer
pozorovat -> to observe
koš -> basket
k léčbě -> to treat
žaludek -> stomach
rám -> frame
motoru -> engine
zmínit -> to mention
vyděsit -> to scare
nějak -> somehow
začátek -> beginning
nudný -> dull
chata -> cabin
chata -> cottage
přilákat -> to attract
poněkud -> somewhat
navždy -> forever
individuální -> individual
enormní -> enormous
obklopit -> to surround
správné -> correct
rok -> year
stěží -> hardly
ostrov -> island
pivo -> beer
pán -> Lord
pán -> lord
prohrát -> to lose
představivost -> imagination
zoufalství -> despair
horní -> top
horní -> upper
extrémně -> extremely
chuť -> taste
plán -> plan
místní -> local
spáchat -> to commit
který -> which
množství -> amount
ulice -> street
kolo -> round
kolo -> wheel
dokonale -> perfectly
sedadlo -> seat
trpět -> to suffer
nos -> nose
televizi -> television
zcela -> completely
zcela -> entirely
zcela -> totally
roli -> role
hra -> game
jim -> them
relaxovat -> to relax
včera -> yesterday
zabírat -> to occupy
rozličný -> various
navíc -> extra
host -> guest
sedlo -> saddle
kromě -> besides
uvědomit si -> to realize
velký -> big
velký -> large
velký -> grand
prostě -> just
žena -> woman
volný -> loose
opravit -> to fix
mumlat -> to murmur
mumlat -> to mutter
zaneprázdněný -> busy
k bolesti -> to ache
naživu -> alive
až na -> except
nechat si -> to keep
hovno -> shit
otázka -> question
plakat -> to cry
plakat -> to weep
míle -> mile
schodiště -> stair
zda -> whether
pozdravit -> to greet
vysoký -> high
vysoký -> tall
jeho -> his
kopnout -> to kick
pláž -> beach
víra -> faith
paláce -> palace
nenávidět -> to hate
kočka -> cat
dolů -> down
spát -> to sleep
náklonnost -> affection
podlaha -> floor
opilý -> drunk
horký -> hot
paprsek -> beam
uspět -> to succeed
deku -> blanket
utěšit -> comfort
bohatý -> rich
trhnout -> to jerk
moře -> sea
temný -> dark
existovat -> to exist
jít -> to go
složit -> to fold
ovlivnit -> to affect
dobře -> well
dobře -> okay
nečistoty -> dirt
hrnec -> pot
těžký -> heavy
musí -> to shall
téměř -> almost
téměř -> nearly
on -> he
křičet -> to shout
křičet -> to scream
křičet -> to yell
tajemné -> mysterious
poznat -> to recognize
slam -> to slam
znám -> familiar
snížit -> to cut
snížit -> to lower
Řím -> Rome
pěkný -> pretty
pěkný -> nice
lano -> rope
poškození -> harm
poškození -> damage
hospodařit -> farm
úzkost -> anxious
úzkost -> anxiety
zapískat -> to whistle
zábava -> fun
tak určitě -> sure
mokré -> wet
ano -> yes
ano -> jaw
potřebovat -> to need
fotoaparát -> camera
předstírat -> to pretend
přiznat -> to confess
význam -> meaning
význam -> importance
letadlo -> plane
první -> first
ihned -> immediately
vězeň -> prisoner
ohrožení -> threat
matka -> mother
může -> to can
může -> to might
přístřeší -> shelter
vzrušit -> to excite
ruka -> hand
bunda -> jacket
bůh -> God
bůh -> god
výška -> height
prospěch -> benefit
hrdost -> pride
nezbytné -> necessary
zdravotní sestřička -> nurse
docela -> quite
zlatý -> golden
pět -> five
hrozný -> terrible
vražda -> murder
čaj -> tea
zdroj -> source
potit se -> sweat
chlapec -> boy
fotografie -> photograph
verze -> version
polykat -> to swallow
svázat -> to tie
zimní -> winter
uznat -> to acknowledge
povzbuzovat -> to encourage
se modlit -> to pray
opatření -> measure
to je -> its
rozhovor -> interview
by měl -> should
k záchraně -> to rescue
scéna -> scene
síla -> strength
milenec -> lover
detektiv -> detective
ustoupit -> to retreat
soudce -> judge
zvednout -> to lift
délka -> length
stolování -> dining
nějaký -> some
morální -> moral
dost -> enough
hrubý -> rough
k výrobě -> to produce
provozu -> operation
další -> another
další -> next
nahý -> naked
případ -> case
opravdu -> really
barvy -> colour
stříbrný -> silver
policajt -> cop
plamen -> flame
hodina -> hour
mléko -> milk
vlastnit -> to possess
série -> series
způsoben -> due
angličtina -> English
popsat -> to describe
na adresu -> to address
opustit -> to leave
opustit -> to abandon
dokonce -> even
její -> her
její -> hers
sebe -> herself
sebe -> ourselves
váhat -> to hesitate
nemovitostí -> estate
záchvat -> attack
peklo -> hell
klíč -> key
než -> than
k vůli -> to will
rychle -> quickly
rychle -> fast
rychle -> rapidly
výstřel -> shot
do překvapení -> to startle
kuchyně -> kitchen
myšlenka -> idea
obočí -> brow
obočí -> eyebrow
vlasy -> hair
chtít -> to want
procházet -> to crawl
sál -> hall
vyhnout se -> to avoid
hromada -> pile
dar -> gift
večeře -> dinner
večeře -> supper
normální -> normal
náhlý -> sudden
hrad -> castle
nebezpečný -> dangerous
řetězec -> string
stanice -> station
skála -> rock
rezervovat -> book
lék -> drug
hadřík -> cloth
saké -> sake
lpět -> to cling
takový -> such
slyšet -> to hear
zelená -> green
mísa -> bowl
porazit -> to beat
odkaz -> link
prosit -> to beg
utéct -> to flee
ret -> lip
silně -> heavily
zmeškat -> to miss
pozor -> attention
sladký -> sweet
prst -> finger
karta -> card
touha -> desire
pásku -> tape
vystrašit -> to frighten
rád -> glad
již brzy -> soon
navštívit -> to visit
vozík -> carriage
jižní -> south
tým -> team
severní -> north
ženský -> female
spojky -> to clutch
vášeň -> passion
vyvrtat -> to bore
požadovat -> to demand
hlasitý -> loud
viditelné -> visible
vejce -> egg
věž -> tower
ložnice -> bedroom
žít -> to live
mu -> him
podepsat -> sign
vrátit -> to return
duch -> spirit
duch -> ghost
soubor -> file
bota -> boot
před -> before
před -> ago
silný -> strong
silný -> powerful
umění -> art
nehoda -> accident
uklidnit se -> to ease
zítra -> tomorrow
dědeček -> grandfather
postavit -> to build
zatímco -> while
střílet -> to shoot
pevná látka -> solid
pohár -> cup
policie -> police
plýtvat -> to waste
trpěliví -> patient
patnáct -> fifteen
výsledek -> result
typ -> type
podle -> by
potrubí -> pipe
přijmout -> to accept
přijmout -> to embrace
paní -> Mrs
paní -> mistress
dav -> crowd
skutečnost -> fact
oheň -> fire
hluboký -> deep
míč -> ball
se obávat -> to worry
vlna -> wave
jednou -> once
zmatek -> confusion
armáda -> army
dráha -> track
sto -> hundred
roh -> corner
odejít -> to depart
nosit -> to wear
čelit -> counter
meč -> sword
postava -> figure
hodin -> o’clock
čest -> honor
čest -> honour
důležité -> important
posádka -> crew
mluvit -> to talk
mluvit -> to speak
tajemství -> secret
tajemství -> mystery
zářit -> to shine
zářit -> to gleam
mrak -> cloud
vědomí -> consciousness
celé -> heel
vesnice -> village
Červené -> red
potopit se -> to sink
ministra -> minister
pohybovat -> to move
poznámku -> to remark
formulář -> form
poplach -> alarm
prsten -> ring
vaše -> your
vaše -> yours
dokončit -> to finish
na -> to
na -> on
na -> upon
na -> onto
prach -> dust
mladý -> young
kdokoliv -> anyone
vypadat -> to seem
hruď -> chest
devět -> nine
někde -> somewhere
zaměřit -> to focus
domnívat se -> to suppose
mírně -> slightly
finále -> final
průchod -> passage
relativní -> relative
pojem -> notion
literární -> literary
francie -> France
odpovědět -> to answer
odpovědět -> to reply
odpovědět -> to respond
roztáhnout -> to stretch
italština -> Italian
němec -> German
odizolovat -> to strip
pokrčit rameny -> to shrug
platnost -> force
nikdo -> nobody
objednat -> order
závěru -> conclusion
poslední -> last
manželka -> wife
cena -> price
amerika -> America
pták -> bird
proto -> therefore
ocas -> tail
zavřít -> to close
zavřít -> to shut
za -> behind
za -> per
dále -> forth
jak -> how
nárokovat si -> to claim
vzniknout -> to emerge
vzniknout -> to arise
pod -> under
pod -> beneath
uklonit se -> to bow
kousnout -> to bite
do -> into
echo -> to echo
kopat -> to dig
nutit -> to urge
lidové -> folk
vpřed -> forward
vpřed -> ahead
dýchat -> to breathe
stanovit -> to set
stanovit -> to establish
zkusit -> to try
princ -> prince
noha -> foot
noha -> leg
opatrně -> carefully
stín -> shadow
dívka -> girl
květ -> flower
kůlny -> to shed
poezie -> poetry
rostlina -> plant
prsa -> breast
hák -> hook
prodat -> to sell
dopis -> letter
vidět -> to see
kdo -> who
sbírat -> to gather
sbírat -> to collect
provázet -> to guide
respekt -> respect
zvládnout -> to handle
celý -> whole
celý -> entire
buď -> either
vždy -> always
ačkoli -> though
ačkoli -> although
vztah -> relationship
vztah -> relation
volný, uvolnit -> free
tichý -> silent
objevit -> to discover
les -> forest
farmář -> farmer
mít -> to have
postoje -> attitude
v rámci -> within
riziko -> risk
prvek -> element
film -> movie
soud -> court
bílý -> white
jako -> like
principu -> principle
popřít -> to deny
stopa -> trace
báze -> base
tenký -> thin
snadno -> easily
lavice -> desk
lavice -> bench
kapesní -> pocket
vyblednout -> to fade
osobní -> personal
teplo -> heat
teplo -> warmth
řádek -> line
řádek -> row
zkoumat -> to examine
reflexe -> reflection
sdílet -> to share
kruh -> circle
svatba -> wedding
krev -> blood
anděl -> angel
jasně -> clearly
den -> day
místo -> place
způsobit -> to cause
barva -> color
proč -> why
dovednost -> skill
všimnout si -> to notice
koho -> whom
paluba -> deck
více -> more
autobus -> bus
dát -> to give
dát -> to put
časopis -> magazine
firma -> firm
vzduch -> air
jednotná -> uniform
Španělština -> Spanish
závazek -> to oblige
počítat -> to count
obhajovat -> to defend
veranda -> porch
šeptat -> to whisper
kůže -> skin
kůže -> leather
nemocnice -> hospital
upřímný -> honest
spravedlnosti -> justice
připomínat -> to remind
málo -> little
málo -> few
článek -> article
být -> to be
pero -> pen
znamenat -> to mean
stůl -> table
nechat -> to let
tisíc -> thousand
ploché -> flat
pak -> then
svahu -> slope
mnoho -> many
bratranec -> cousin
pro -> for
chlap -> guy
pravidlo -> rule
skutečně -> truly
hloupé -> silly
led -> ice
otec -> father
souhlasit -> to agree
souhlasit -> to accord
podívat se -> to look
malování -> painting
, aby se vešly -> to fit
charakter -> character
chodba -> corridor
smích -> laughter
starý -> old
otočit -> to turn
prohlásit -> to declare
veletrh -> fair
budoucnost -> future
odstoupit -> to withdraw
hluboce -> deeply
rovná -> equal
větev -> branch
země -> country
země -> earth
hodný -> worthy
obsah -> content
singl -> single
hrob -> grave
vydělávat -> to earn
jemný -> gentle
klub -> club
zkusenosti -> experience
sníh -> snow
obtížný -> difficult
oni sami -> themselves
myslet -> to think
zabezpečení -> to secure
rozšířit -> to spread
rozšířit -> to extend
moje maličkost -> myself
zabít -> to kill
tvrdý -> hard
těžit -> mine
klepnutím -> to tap
sloužit -> to serve
sbalit -> to pack
ozdobný -> fancy
plný -> full
pokud -> unless
přesvědčení -> belief
tábor -> camp
válka -> war
dosáhnout -> to reach
podnikání -> business
třást -> to shake
náměstí -> square
hrdina -> hero
bloudit -> to wander
výše -> above
vyhrát -> to win
obětování -> sacrifice
uvnitř -> inside
náboženské -> religious
profesionální -> professional
zachytit -> to capture
cvičení -> exercise
báječné -> wonderful
pozvat -> to invite
ocenit -> to appreciate
národ -> nation
zeď -> wall
umlčet -> silence
dáma -> lady
vypnuto -> off
papír -> paper
věta -> sentence
bezpečný -> safe
přežít -> to survive
král -> king
během -> during
patřit -> to belong
ven -> out
